------------------------------------------------------------
------------------------------------------------------------
------------------------------------------------------------
------------------------------------------------------------
------------------------------------------------------------
------#-###-###-#########-----------------------------------
-----# #   #   #         #----------------------------------
-----# # # # # # ### ### #----------------------------------
-----#   #   #   # # #   #----------------------------------
-----# ##-######## # # ##-----------------------------------
-----#   #     #   # #--------------------------------------
------## # ### ### # #------------###-----------------------
-----#     # #     # #-----------#   #----------------------
-----# ##### # ##### #-----------# # #----------------------
-----# #   #   #     #-----------# # #----------------------
------## # ##### ####-----------## # ##---------------------
-----#   # #     #-------------#   #   #--------------------
-----# ### # ####--------------# ##### #--###---------------
-----#   # #   #---------------# #   # #-#   #--------------
-----# # # # # ####------------# ### # ### # #--------------
-----# # # # #     #-----------# #   #     # #--------------
-----# # # ####### #-----------# # ######### #--------------
-----# # #         #-----------# # #   #     #--------------
------## ##########---------#### # # # # ####---------------
-----#   #-----------------#   # #   # #     #--------------
-----# ######-#######-###-## # # # ### ##### #--------------
-----#       #       #   #   #   # # #     # #--------------
-----# ##### # ##### # # ######### # ##### # #--------------
-----#   #   #     #   #       #   #     #   #--------------
------## # # ##### ########### # ####### ####---------------
-----#   # # #     #       #   # #       #   #--------------
-----# ### # # ##### ##### # ### # ##### # # #--------------
-----# #   # #   # #     # # #   #     #   # #--------------
------## ### ### # # ### # # # ### ### # ####---------------
-----#   #   # # # #   # # #   #     # # #   #--------------
-----# ### ### # # ### # ########### # ### # #--------------
-----# # # #   # # #   #           # #     # #--------------
-----# # # # # # # # ##### ##### # ### ##### #--------------
-----# # #   # # #   #   #   #   #   #     # #--------------
-----# # ##### # ##### # ### # ##### ### ### #--------------
-----# # #     # #     # #   # #   # #X  #   #--------------
-----# # # ##### # ##### ##### # # # ##### # #--------------
-----# #     #   # # #   #   #   # #     # # #--------------
-----# ####### ### # # ### # ##### ##### # # #--------------
-----#             #       #       #       # #--------------
------#############-#######-#######-#######-#---------------
------------------------------------------------------------
------------------------------------------------------------
------------------------------------------------------------
------------------------------------------------------------
------------------------------------------------------------
------------------------------------------------------------
------------------------------------------------------------
------------------------------------------------------------
------------------------------------------------------------
------------------------------------------------------------
------------------------------------------------------------
------------------------------------------------------------
------------------------------------------------------------
------------------------------------------------------------
