------------------#-###-###-#########-----------------------------
-----------------# #   #   #         #----------------------------
-----------------# # # # # # ### ### #----------------------------
-----------------#   #   #   # # #   #----------------------------
-----------------# ##-######## # # ########-----------------------
-----------------#   #     #-  # #         #----------------------
------------------## # ### ### # ######### #--###-----------------
-----------------#     # #     # #     #   #-#   #----------------
-----------------# ##### # ##### # ### # ##--# # #----------------
-----------------# #   #   #     # # # # # --# # #----------------
------------------## # ##### ##### # # # # ### # ##---------------
-----------------#   # #     #     #   # # #   #   #--------------
-----------------# ### # ##### # ### ### # # ##### #--###---------
-----------------#   # #   #   # #     # # # #   # #-#   #--------
-----------------# # # # # ##### ##### # # # ### # ### # #--------
-----------------# # # # #     #   #   # # # #   #     # #--------
-----------------# # # ####### # # # ### # # # ######### #--------
-----------------# # #         # # # #     # # #   #     #--------
------------------## ########### # ### ##### # # # # ####---------
-----------------#   #           #     #   # #   # #     #--------
-----------------# ##############-###### # # # ### ##### #--------
-----------------#       #       #   #X  #   # # #     # #--------
-----------------# ##### # ##### # # ######### # ##### # #--------
-----------------#   #   #     #   #       #   #     #   #--------
------------------## # # ##### ########### # ####### ####---------
-----------------#   # # #     #       #   # #       #   #--------
-----------------# ### # # ##### ##### # ### # ##### # # #--------
-----------------# #   # #   # #     # # #   #     #   # #--------
------------------## ### ### # # ### # # # ### ### # ####---------
-----------------#   #   # # # #   # # #   #     # # #   ---------
-----------------# ### ### # # ### # ########### # ### # #--------
-----------------# #-# #   # # #   #           # #     # #--------
-----------------# #-# # # # # # ##### ##### # ### ##### #--------
-----------------# # #   # # #   #   #   #   #   #     # #--------
-----------------# # ##### # ##### # ### # ##### ### ### #--------
-----------------# # #     # #     # #   # #   # #X  #   #--------
-----------------# # # ##### # ##### ##### # # # ##### # #--------
-----------------# #     #   # # #   #   #   # #     # # ---------
-----------------# ####### ### # # ### # ##### ##### # - ---------
-----------------#             #       #       #--     # #--------
------------------#############-#######-#######---#--#--#---------
------------------------------------------------------------------

